xxxxx xxxx
x    x   x
xx  xx   x
xxxx xxx x
xx xx x  x
xxx xxx xx
xxxxxxxxxx
xxxx xxxxx
x        x
xx   xx xx